Danny
XXXXXXXXXX
X   X    X
XXXOX XX X
X   X  X X
XXX XX XXX
X        X
X XXXXXX X
X XS     X
X XXXXXX X
XXXXXXXXXX
